XXXXXXXXXXXXXXXXXXXX
XO...........XX....X
X.XXXX.XXXXX.XX.XX.X
X.XXXX.XXXXX.XX.XX.X
X......XXXXX.XX.XX.X
X.XXXX.............X
X.XXXX.XX.XXX--XXX.X
X......XX.XXG  GXX.X
X.XX.XXXX.XXXXXXXX.X
X.XX.XXXX..........X
X.XX......XXX.XXXX.X
X.XXXXX.XXXXX.XXXX.X
X.XXXXX.XXXXX.XXXX.X
X........P........OX
XXXXXXXXXXXXXXXXXXXX
